.....####.
.#..ooo...
....###...
.#.o..x..o
....p.....
.#....###.
oox.x.....
..#...x...
....#.....
.oo..##.oo
